map
#######
#@  $O#
#######

map
############
#OO  #     ###
#OO  # $  $  #
#OO  #$####  #
#OO    @ ##  #
#OO  # # $  ##
###### ##$ $ #
  # $  $ $ $ #
  #    #     #
  ############

map
        ########
        #     @#
        # $#$ ##
        # $  $#
        ##$ $ #
######### $ # ###
#OOOO  ## $  $  #
##OOO    $  $   #
#OOOO  ##########
########
end